###             ###############     ############
###             ###############     ############
###             ###############     ############
###             ###############     ############
###      ######################     ############
###      ######################     ############
###      ####                       ############
###                                 ############
###      ####                       ############
###      ############    ######     ############
###      ############    ######     ############
###      ############    ######     ############
###      ############    ######     ############
###      ############               ############
###      ############               ############
#####################                   ########
######           ####    ######     ############
######           ####    ######     ############
######           ##############     ############
######                              ############
######       #############    ##################
######   #################    ##################
######   #################    ######          ##
######         ###########    ######          ##
######                  ##    ######    ##    ##
###########    ######## ##    ######    ##    ##
###########    ######## ##    ######    ##    ##
###########    ##    ## ##              ##    ##
###########    ## ## ## ##              ##    ##
###########    ## ##### ##         #          ##
###########    ##       ##         #          ##
###########    ################    #     #######
###########        #########       #     #######
###########                        #     #######
###########                        #     #######
###########            #############     #######
###########                              #######
###########    #################################
###########    #################################
################################################
                                                
                                                
